16 16
99 99 99 99 99 99 99 99 99 99 99 99 99 99 99 99
99 01 00 03 07 01 04 00 00 00 03 02 02 01 03 99
99 03 01 00 07 02 01 02 02 00 00 01 00 13 01 99
99 02 00 00 07 00 00 02 00 04 00 02 03 05 01 99
99 02 02 03 12 06 06 06 06 11 06 06 06 06 06 99
99 00 01 00 03 00 02 03 01 07 00 02 00 02 01 99
99 00 04 02 00 03 02 01 00 07 00 00 00 01 01 99
99 00 02 00 01 10 06 06 06 09 03 02 02 01 00 99
99 02 00 00 00 07 00 00 01 00 02 02 02 00 00 99
99 06 06 06 06 11 04 03 00 00 01 01 01 00 04 99
99 02 00 00 01 07 02 02 02 00 00 02 02 01 00 99
99 03 02 13 00 07 01 02 02 00 00 01 02 02 00 99
99 03 02 05 00 07 01 02 02 00 04 01 02 02 00 99
99 06 06 06 06 09 01 02 02 00 00 01 02 02 04 99
99 00 02 02 00 03 01 02 02 01 00 01 02 02 00 99
99 99 99 99 99 99 99 99 99 99 99 99 99 99 99 99