3 2 2 3 b 2 0 3 0 3 2 2
0 1 0 3 b 1 4 0 0 0 3 2
0 3 1 0 b 2 1 2 2 0 0 1
3 2 0 0 b 0 0 2 0 5 0 2
2 2 2 3 f a a a a e a a
0 0 1 0 3 0 2 3 1 b 4 2
3 0 4 2 0 3 2 1 0 b 0 0
1 0 2 0 1 d a a a c 3 2
2 2 0 5 0 b 0 4 1 0 2 2
a a a a a c 2 3 0 0 1 1
1 2 0 0 1 0 2 2 2 0 0 2
3 3 2 2 0 3 1 2 2 3 0 1
