03 02 02 03 07 02 00 03 00 03 02 02
00 01 00 03 07 01 04 00 00 00 03 02
00 03 01 00 07 02 01 02 02 00 00 01
03 02 00 00 07 00 00 02 00 05 00 02
02 02 02 03 12 06 06 06 06 11 06 06
00 00 01 00 03 00 02 03 01 07 04 02
03 00 04 02 00 03 02 01 00 07 00 00
01 00 02 00 01 10 06 06 06 09 03 02
02 02 00 05 00 07 00 04 01 00 02 02
06 06 06 06 06 09 02 03 00 00 01 01
01 02 00 00 01 00 02 02 02 00 00 02
03 03 02 02 00 03 01 02 02 03 00 01
